// Test map with walls — 10x10
// # = wall, R = resource, . = passable
##########
#R.......#
#.##.....#
#....R...#
#.##.....#
#R.......#
#....##..#
#.R......#
#........#
##########
