# swarm-arena example map 10x10
# R = resource, . = empty
..........
..R.......
....R.....
..........
.......R..
...R......
..........
......R...
..R.......
..........
