# swarm-arena 20x20 map with 30 resources
...R....R...........
........R....R......
R.....R..R..........
..........R.........
.......R............
....................
....R...............
.R....R.R....R......
..........R.........
....................
....................
...R................
..RR................
.....R..............
....................
....................
....................
R.RR..R.......R.....
..R........R..R.....
.........R.R....R...
